#^.^~****^*~~.~^~..~~~^~.^~.*~**.^^*^*^~..*^^..~^.
*#*~*.~^^^~~.*~*.**.~~^*^**.^~*^^.*^...^..^.**.~^*
^^#**~.*^*^..^**.~~~.~*.~^^~^~^.^~^*~**.~*^.^**.*.
*~~#~^.~*~^~^^*^**.~.*^^*~~^^*~.^.*^^*^.^.~~^^^*~.
*.^~#^.~^.^.^^*~^~~*^..^~^~~^.*^^..**.**~.~~^~*~**
^.^^~#.*~**.*~*^*~^*~~^.^.~.~^**~.^^^^*.~.~~~^^.^.
*~~.*#^~~~^*.^*~~~*^.^**^*^.^.^~~***^^*^.~^^.^^.~.
.~.*~~#*.**.~^^~**^.^.^~~~^.~.^~~^^.~^^.^^~.~.~.*^
.^^^~~#~.^.~.*~.~~..~*~^.~**~..^****~.*~^~~*~**^~^
^^^*^^*#...*.^^*^^^.*~*~^^~*~~.~****~~~~***.^^~~^~
..*^^^^^#^~.^~.^.^^~*~^*~**^*^.~~~*^.^^~**~*~.....
**.^~~~^~#~****.**^~.^.*^^^~.^...~.**^^^^~^.~^~.~*
^*~.*.~*^#~#^^^^^*~.**~^.*^*.~~..^~~~*~*^.~~^*^*^^
~*^.^..**~#*#*^~***^~~*^*.*~..~^^***^.*~.^*^^^^.~.
*~^~^**^^*^^~#*~^^*~~~*^*~~~~*~^^^*~..~~~~~.*~^~*.
^.*.^*^**^^^~*#.*.~^~~~^..~~~*~~^*~..^^.^~*.^~^~**
.***^..*^~~~~^~#*^~~.*.~^.^^*.***^~^.*....~.^.*~^^
^^~~~~.**.*.^^*#^~~^....*~*^~*^^.^~~~^*.~^^^~**^~~
^~~*^*.~.*^^^*^.##.~*...~**^.^^~.^^.^..^.^**.^^..*
~^***~^.~.~^^^*~~~#*..^~^^.~^.~.**...~^~**~^~~**^~
~~~^~.^*.^*.~*.*~~^#.~*^^~~**.*.*.~^^^..^.~^.*.^~~
^^~...^.*~.^^**~^~*.#^~^~*....^.^^**~.*.^^*..~*~.*
^..^...~.~.*.~***~*~~#..~*~^^~~^~**^~~^*^^~*.~*^*^
*^.**^~*****.~~~..~^~.#.^*~^.^^*^..*~^.^.^*.^.~^^*
~...~*^....*^.*^^*...^#~~..^.*~.*~.*^.^*^*^.****^~
^..~***^.*^~~.****.~*^#~.^~*.~^*^~^.****~..~*..*^~
.~^~**~^^..~~~^..*~*.^*#~..^^*.~.*..*~~*~.^~.~*~~.
.***~..~**^.~.~.~*.~~**.#^.^~..~*~~~~*.**~~^..^.^^
~.*.~^*^*~^.~*..*~^~~.*.*#.*.*..^~.*~^^*.~^.^~^**^
.*^~^^*.^*.~*...*~~~*.**.~#..*.*^.^*.^*~*.^~^**^*.
.~..*....~..~.***~..~^..~~^#^*^~^^~~**^.*~**^**^^*
^.*.~.^.**^*^.~^^*.~..*^~*^*##.~**..^.~~*..^*^~*.~
^~~^~~*.~^^~~^**.^.^^^*^.*^^~~#^.*~^*^^..**..**..^
^.^*.*^..*.~~.^^***^.*~..~.**^*#~^...^^~*.~^~^..~~
~^^.^..*^^.**.~~^*~*^~*~^~~.~*#^~.~*^~*.*..^.^^*^*
^^.~*^~~*.~~*~.^..~*.^.~**.^*^#^~.**.~*.~...~~..*.
.~..^.~.~.^*.~^*~.~.*^*~~*.^.**#***~*~~*^~~~^.~~*~
~.*..^^*^~*.~~.~.^~..~.~^^^.*~*.#*~^*~*^*^^~..^~^^
*.^*^**^*.^^*....**..~^^~.^*^.*~*#**^^..*.^^*^^^.~
^*^~^^*.~*~^*~^~~.*.^*^~*^^~.*~.*~#**.*~^~~.~*^~~*
~~**~*.^.*~..~~^^^~^^^.~***^*.^*~^#~^~*~**...~..~.
*~**^~~.^.*.~^**~*^^.*^*.^~~*~~~*^.#..~~^*^.*^.^.*
.*^~..*~.*^^^^^~~^^*.~*.~~~.***~^.*.#~~******~~^*.
.^^..^.^*^~^.~*...**~~~.**^*~~~*^***~#*^~^~~^^^*.*
**.**~.**~.*.*^~~.~^.*^.~~*.^*.~.***~*#^..~*.~*^*^
~..^.****^.****~^~***..^^^^*^.~*^^*.~~#^**^*~^*.~~
^*~^.~*...^^.^~.^^..~^...**...^****^*~#~#^##~^*~.~
...^~^.~^^~~~~.*^~.^~***~~^^^.*^^.~.^*~#~#*^#**^~^
.~~~~~^^.~~*^.~^^^**~^~.^~^~*..^*~^^*..*~^~**#*#^.
~^**.~**..*^~^^^.^*^~^~*^.~*~.^.**.^.^^.~**^~~#~##
